R 840 680
NO includes/textures/redbrick.xpm

SO includes/textures/bluestone.xpm

WE includes/textures/greystone.xpm

EA includes/textures/purplestone.xpm

S includes/textures/barrel.xpm
F  39,38,43
C  159,190,215

        1111111111111111111111111 
        1000000000110000000000001   
        1011000001110000002000001    
        1001000000000000000000001 
111111111011000001110000000000001
100200000011000001110111110111111       
11110111111111011100000010001
11110111111111011101010010201
11000000110101011100000010001
10002000000000001100000010001
10000000000000001101010010001
11000001110101011111011110N011
111001111 1100111 11101111100111
